8 8 8 8 8 8 8 8 8 8 8
8 1 1 1 1 1 1 1 1 3 8
8 1 4 1 1 2 1 1 5 1 8
8 1 1 1 1 6 1 1 1 1 8
8 1 1 1 1 1 1 1 1 1 8
8 8 8 8 8 8 8 8 8 8 8